00000000000000000000
00000000001000000000
00000000001000000000
00000000001000000000
00000000001111111000
00001111001000010000
00001001111100010000
11111100000000010000
00100000000000011100
00100100000000010100
00100000000000010111
00100000000000010000
00100000000000010000
00111111110000111100
00001000010000100000
00001000010000100000
00001000010000100000
00001000010000111110
00001111011111100000
00000000000000000000
